NO ./textures/NO.xpm
SO ./textures/SO.xpm
WE ./textures/WE.xpm
EA ./textures/EA.xpm

F 96,96,96
C 15,5,107


                          111111
                     111111000011111111                     
111111111111111111111100000000000000001111
111111111111111111111000000000000000000001111
111111111111111111000000011111110000000000001111111111111111
111111111111111100001111111111111111100000000011111111111111
111111111111110000111111111111111111111000000001111111111111
111111111111100011111111111111111111111110000000111111111111
111111111111000111111111111111111111111111000000011111111111
111111111110001111111111111111111111111111100000001111111111
111111111110011111111111111111111111111111110000001111111111
111111110000011111111111111000011111111111110000001111111111
111111111000011111111111100000000111111111111000000000011111
111111111111111111111111110000001111111111111000000111111111
111111111111111111111111111000011111111111110000001111111111
111111111111111111111111111111111111111111110000001111111111
111111111111111111111111111111111111111111100000011111111111
111111111111111111111111111111111111111110000000011111111111
111111111111111111111111111111111111111100000000111111111111
111111111111111111101111111111111111100000000011111111111111
111111111111111111000000111111111000000000000111111111111111
111111111111111111110000000000000000000000011111111111111111
111111111111111111111111000000000000000011111111111111111111
1111111111111111111111111111000N0000111111111111111111111111
111111111111111111111111111111111111111111111111111111111111