NO ./textures/FNO.xpm
SO ./textures/FSO.xpm
WE ./textures/FWE.xpm
EA ./textures/FEA.xpm

F 77,77,77
C 0,0,33

        1111111111111111111111111
        1000000000110000000000001
        1001000000000000000000001
        1001000000000000000000001
111111111001000001110000000000001
100000000001000001110111100011111
11100011111111011000000010001  
11100011110000000001010010001
11000000110101010000000010001
10000000000000000000000000001
10000000000000001101010010001
11000001110101011111010010N0111
11110111 1110101 101110010001
11111111 1111111 111111111111