NO test.xpm
SO test.xpm
F 100,0,123

WE test.xpm

C 225,30,0
EA test.xpm

 1111111111111111111111111
 1000000000110000000000001
 1011000001110000000000001
 1001000000000000W00000001
11011000001110000000000001
10011000001110000000001111
11111111111111111111111111