NO test.xpm
SO test.xpm
F 100,0,123

WE test.xpm

C 225,30,0
EA test.xpm

        11111111111
        10000000001 1111111111111
        1011000001111000000000001
        100100000000000000000000111
11111111101100000111000000000000001
10000000011110000111011111111111111
111101111  11011100000010001
11110111111111011101010010001
1100000011  101011100000010001
1000000001  100001100000010001
1000000001  100011101010010001
1100000111110101 111011110N011111
11110111 1110101 1011110100010001
11111111 1111111 1111111111111111