NO ./textures/FNO.xpm
SO ./textures/FSO.xpm
WE ./textures/FWE.xpm
EA ./textures/FEA.xpm

F 83,83,83
C 0,0,40


                         1111 
                    1111100001111111                     
                   10000000000000000111
                11100000000000000000000111
              110000000111111100000000000011
            11000011111       111110000000001
           1000011                 11000000001
          100011                     1100000001
         10001                         100000001
        10001                           100000001
      111001             1111            10000001
     1000001           11000011          100000011111
      100001          1000000001          1000000000W1
       1111            10000001           10000001111
                        100001           10000001
                         1111            10000001
                                       110000001
                                      1000000001
                 1                 111000000001
                101111         111100000000011
               10000001111111110000000000001
                110000000000000000000000011
                  11110000000000000000111
                      1111000000001111
                          11111111